##########################
#........................#
#........................#
#........................#
###......................#
#........................#
#........................#
#........................#
#........................#
#........................#
##########################
